2222222222222222222222222222222222222
2222222222333333333333222222222222222
2222222223111111111111322222222222222
2222222223111111111111322222222222222
2222222223111111111111322222222222222
2222222223111111111111322222222222222
2222222223111111111111322222222222222
2222222222333333333333222222222222222
2222222222222222222222222222222222222
2222222222333333333333222222222222222
2222222223111111111111322222222222222
2222222223111111111111322222222222222
2222222223111111111111322222222222222
2222222223111111111111322222222222222
2222222223111111111111322222222222222
2222222222333333333333222222222222222